EQS = "countries/Equestria.txt"
DRG = "countries/Dragon.txt"
OLE = "countries/Olenia.txt"
CHN = "countries/Changeling.txt"
YAK = "countries/Yakistan.txt"
GRF = "countries/Griffon.txt"
STG = "countries/Stalliongrad.txt"
BUF = "countries/Buffalo.txt"
CRY = "countries/CrystalEmpire.txt"
PLB = "countries/PolarBears.txt"
PNG = "countries/Pinguins.txt"
STL = "countries/StarlightVillage.txt"
NLR = "countries/NewLunarEmpire.txt"
VAN = "countries/Vanhoover.txt"
SCS = "countries/SouthStates.txt"
BAL = "countries/Baltimare.txt"
NMS = "countries/NightSupporters.txt"
CES = "countries/CelestialSupporters.txt"
JUN = "countries/JungleNation.txt"
GFF = "countries/GriffonFrontier.txt"
ROC = "countries/Rockville.txt"
JAK = "countries/Jakistan.txt"
TEM = "countries/Temple.txt"
GEU = "countries/GreaterEquestrianUnion.txt"
SOL = "countries/SolarEmpire.txt"
ZRS = "countries/ZecoranResistance.txt"
CCN = "countries/ChangelingHarmony.txt"
LSP = "countries/LosPegasus.txt"
MAN = "countries/Manehattan.txt" ## Equestrian East Coast
ELF = "countries/EquestriaLiberationFront.txt"

############################ Griffon Continent ####
ZEI = "countries/Zeusa.txt" #Modded
GRI = "countries/GriffonEmpire.txt"
DED = "countries/DeadCountry.txt"
HLR = "countries/HolyOrder.txt"
RTN = "countries/Rottenrift.txt" #Modded
CLD = "countries/Cloudsbury.txt" #Modded
FAT = "countries/Fatass.txt"
FAW = "countries/FatassWarlord.txt"
THE = "countries/Lacona.txt" #Modded
MIT = "countries/Minotauria.txt"
ERI = "countries/HouseErie.txt"
EYR = "countries/HouseEyrie.txt"
MNE = "countries/Ubera.txt" #Modded
CIA = "countries/Sicaea.txt" #Modded
SIC = "countries/Sicameon.txt" ### Peaceful Lord jkkk 0)))))
OSL = "countries/Ostland.txt" #Modded
SYD = "countries/Sydvasland.txt" #Modded
BRS = "countries/BoreanOrder.txt" #Modded
VED = "countries/Vedina.txt"
CYA = "countries/Cyanolisia.txt"
FRN = "countries/Franmistria.txt"
PYT = "countries/Griffinheim.txt"
ARA = "countries/Arantiga.txt"
GCA = "countries/IslandCompany.txt" #Modded
TRN = "countries/Tunesine.txt" #Modded
EQC = "countries/EquestrianColony.txt"
KST = "countries/Kuststaat" #Modded
TRD = "countries/TradeFed.txt"
PUN = "countries/Punea.txt" #Modded
WNG = "countries/Wingbardy.txt"
DEV = "countries/DeVleugels.txt" #Modded
FEA = "countries/Feathisia.txt"
CHR = "countries/Francea.txt" #Modded
HEL = "countries/Adelart.txt"
REM = "countries/Remae.txt" #Modded
ROU = "countries/Romau.txt"
AWL = "countries/Awle.txt" #Modded
AET = "countries/Griefwald.txt"
GAL = "countries/Gallea.txt" #Modded
JER = "countries/Jerklord.txt"
JEB = "countries/Jerkbro.txt"
JFT = "countries/Jerkfather.txt"
JES = "countries/Jerksister.txt"
JRR = "countries/Jerkrelatives.txt"
BOI = "countries/Someboibuthesactuallyevil.txt"
PYR = "countries/Pyrdain.txt" #Modded
CYL = "countries/Cyldone.txt" #Modded
LAK = "countries/Lakelord.txt"
ELA = "countries/Elesia.txt" #Modded
FAL = "countries/Falcor.txt" ## Peaceful Lord <<<<
ATR = "countries/Aetern.txt"
AVI = "countries/HouseAvian.txt"
POM = "countries/Pomovarra.txt"
VIN = "countries/Vinovia.txt"
GRN = "countries/Greenback.txt"
YAL = "countries/Yaledom.txt"
ANG = "countries/Angriver.txt"
ZES = "countries/ZebraSettlement.txt"
OLV = "countries/OleniaVikings.txt"
GRW = "countries/GriffonWill.txt"
BRF = "countries/Brodfeld.txt" ## aka losing memelord
BAN = "countries/GriffonBandits.txt"
STE = "countries/Stellan.txt" #Modded
STW = "countries/Strawberry.txt"
HLQ = "countries/HellquillCountry.txt"
KAT = "countries/KaterinQueendom.txt"
ADM = "countries/Adamanta.txt" #Modded
BRZ = "countries/Bronzehill.txt"
FLR = "countries/Flowerepublic.txt" #Modded
FLO = "countries/Flowena.txt"
GRY = "countries/Gryphia.txt"
UDG = "countries/DuchyUnion.txt" #Modded
TAL = "countries/Talouse.txt"
RVS = "countries/Riversword.txt"
LNS = "countries/Longsword.txt"
LUS = "countries/Lushland.txt"
ARC = "countries/Arcturine.txt" #Modded
FIR = "countries/FirtreeCommunes.txt"
IPA = "countries/Iapea.txt" #Modded
FEZ = "countries/Fezera.txt"
BNT = "countries/Brantbeak.txt" #Modded
MNC = "countries/MountainGriffons.txt"
WAT = "countries/Watertown.txt"
FBK = "countries/Farbrook.txt"
PYH = "countries/Pythagoria.txt" #Modded
RMI = "countries/Remia.txt" #Modded
KAV = "countries/Kaiv.txt" #Modded
SMF = "countries/Somefled" #Modded
AEG = "countries/Aegland.txt" #Modded
TLV = "countries/Talvona.txt" #Modded
GWL = "countries/Griffonwill.txt" #Modded
ACU = "countries/Acuta.txt" #Modded
LIF = "countries/Lifov.txt" #Modded
GRU = "countries/Gryphus.txt"
HAU = "countries/Hauklands.txt"
SRS = "countries/SocialistRepublicofSocialists.txt"
EQP = "countries/PonyProtectorate.txt"
NCH = "countries/VillageChangelings.txt"
HIB = "countries/Hibernians.txt" #Modded
NTR = "countries/NorthernTribes.txt"
DMT = "countries/DaimondMountain.txt"
LCT = "countries/LakeCity.txt"
RCT = "countries/RiverCity.txt"
NIM = "countries/Nimbusia.txt"
WIT = "countries/Wittenland.txt"
BAK = "countries/Baka.txt"
DEP = "countries/Deponya.txt"
FRE = "countries/Freeponies.txt"
BAR = "countries/Barrd.txt"
EWI = "countries/EventWindego.txt"
LSC = "countries/LongswordCommunist.txt"
LSM = "countries/LongswordMilitary.txt"
JZR = "countries/Jezergrad.txt" #Modded
PNE = "countries/Ponempire.txt" #Modded
SFU = "countries/SouthernUnion.txt" #Modded
GRK = "countries/GriffkingMarch.txt" #Modded
SWL = "countries/SouthernWittenland.txt" #Modded
BBK = "countries/BigBakara.txt" #Modded
DMR = "countries/DiamondReservation.txt" #Modded
KUR = "countries/Kurland.txt" #Modded
OCU = "countries/OccupiedRivers.txt" #Modded
#########################



